4-chan	4-chan	NNP	NOUN
4-Chan	4-chan	NNP	NOUN
Black-berry	Blackberry	NNP	NOUN
counter-strike	Counterstrike	NNP	NOUN
Counter-strike	Counterstrike	NNP	NOUN
Dark-Web	dark-web	NN	NOUN
Deep-Web	deep-web	NN	NOUN
Dark-web	dark-web	NN	NOUN
Deep-web	deep-web	NN	NOUN
dark-web	dark-web	NN	NOUN
deep-web	deep-web	NN	NOUN
e-communication	e-communication	NN	NOUN
e-communications	e-communication	NN	NOUN
e-communicate	e-communicate	_	_
e-communicates	e-communicate	_	_
e-communicated	e-communicate	_	_
face-book	FaceBook	NNP	NOUN
Face-book	FaceBook	NNP	NOUN
Face-Book	FaceBook	NNP	NOUN
game-boy	Game Boy	NNP	NOUN
Game-boy	Game Boy	NNP	NOUN
Game-Boy	Game Boy	NNP	NOUN
Ghost-Busters	Ghostbusters	NNP	NOUN
Ghost-busters	Ghostbusters	NNP	NOUN
internet-based	internet-based	_	_
Internet-based	Internet-based	_	_
Internet-Based	Internet-Based	_	_
i-phone	iPhone	NNP	NOUN
i-Phone	iPhone	NNP	NOUN
I-Phone	iPhone	NNP	NOUN
lap-top	laptop	NN	NOUN
linked-in	LinkedIn	NNP	NOUN
Linked-in	LinkedIn	NNP	NOUN
Linked-In	LinkedIn	NNP	NOUN
on-line	online	_	_
ps-3	PS3	NNP	NOUN
ps-4	PS4	NNP	NOUN
PS-3	PS3	NNP	NOUN
PS-4	PS4	NNP	NOUN
Ps-3	PS3	NNP	NOUN
Ps-4	PS4	NNP	NOUN
social-media	social-media	_	_
social-networking	social-networking	_	_
social-network	social-network	_	_
snap-chat	Snapchat	NNP	NOUN
spam-account	spam-account	NN	NOUN
my-space	MySpace	NNP	NOUN
web-site	website	_	_
word-press	WordPress	NNP	NOUN
Word-press	WordPress	NNP	NOUN
Word-Press	WordPress	NNP	NOUN
you-tube	YouTube	NNP	NOUN
You-tube	YouTube	NNP	NOUN
You-Tube	YouTube	NNP	NOUN
lol-cow	lolcow	NNP	NOUN
lol-cow.farm	lolcow.farm	NNP	NOUN
X-men	X-Men	NNP	NOUN
X-Men	X-Men	NNP	NOUN
x-Men	X-Men	NNP	NOUN
x-men	X-Men	NNP	NOUN